#architectEn誤	正

NIKKEN SEKKEI Planners Architects & Engineers	NIKKEN SEKKEI
TAKENAKA KOMUTEN CO. LTD	TAKENAKA CORPORATION
TAKENAKA CORPORATION(DESIGN DEVELOPMENT)	TAKENAKA CORPORATION
NIHON Architects Engineers&Consultants	NIHON SEKKEI
NIHON Architects Engineering & Consultants	NIHON SEKKEI
NIHON SEKKEI Inc.	NIHON SEKKEI
NIHON SEKKEI, INC.	NIHON SEKKEI
NIHON SEKKEI KANSAI BRANCH	NIHON SEKKEI
NIHONSEKKEI	NIHON SEKKEI
NIHON SEKKEI(MASTER ARCHITECT)	NIHON SEKKEI
MITSUBISHI JISHO DESIGN	MITSUBISHI JISHO SEKKEI
MITSUBISHI JISHO SEKKEI INC	MITSUBISHI JISHO SEKKEI
MITSUBISHI JISHO SEKKEI INC.	MITSUBISHI JISHO SEKKEI
MITSUBISHI JISHO	MITSUBISHI JISHO SEKKEI
SHIMIZU Architects and Engineers	SHIMIZU CORPORATION
SHMIZU Corporation	SHIMIZU CORPORATION
SHIMIZU ARCHITECTS AND ENGINEERS	SHIMIZU CORPORATION
SHIMIZU CORPORAT10N DESIGN DIVISION	SHIMIZU CORPORATION
SHIMIZU CORPORATION ARCHITECTS & ENGINEERS	SHIMIZU CORPORATION
KAJIMA　DESIGN	KAJIMA DESIGN
YAMASHITA SEKKEI INC.	YAMASHITA SEKKEI
YAMASHITASEKKEI INC.	YAMASHITA SEKKEI
YAMASHITA SEKKEI， ARCHITECTS， ENGINEERS & CONSULTANTS	YAMASHITA SEKKEI
KENGO KUMA AND ASSOCIATE	KENGO KUMA & ASSOCIATES
KENGO KUMA& ASSOCIATES	KENGO KUMA & ASSOCIATES
KENGO KUMA& ASSOCIATES	KENGO KUMA & ASSOCIATES
KENGO KUMA&ASSOCIATES	KENGO KUMA & ASSOCIATES
NTT POWER AND BUILDING FACILITIES	NTT FACILITIES
NTT-F	NTT FACILITIES
AXS SATOW INC.	AXS SATOW
sato sogo keikaku	AXS SATOW
KUMESEKKEI	KUME SEKKEI
OBAYASHI	OBAYASHI CORPORATION
OBAYASHI CORP	OBAYASHI CORPORATION
Obayashi corporation (design and construction planning)	OBAYASHI CORPORATION
Ishimoto architects & engineers	ISHIMOTO ARCHITECTURAL & ENGINEERING FIRM
Ishimoto Architectural Office	ISHIMOTO ARCHITECTURAL & ENGINEERING FIRM
ISHIMOTO Architectural & Engineering	ISHIMOTO ARCHITECTURAL & ENGINEERING FIRM
ISHIMOTO Architectural&Engineering	ISHIMOTO ARCHITECTURAL & ENGINEERING FIRM
ISHIMOTO ARCHITECTUAL & ENGINEERING FIRM	ISHIMOTO ARCHITECTURAL & ENGINEERING FIRM
Ishimoto architects	ISHIMOTO ARCHITECTURAL & ENGINEERING FIRM
ISHIMOTO DESIGN	ISHIMOTO ARCHITECTURAL & ENGINEERING FIRM
ISHIMOTO ARCHITECTURAL  ENGINEERING FIRM TAKANORI ITO	ISHIMOTO ARCHITECTURAL & ENGINEERING FIRM
TAISEI DESIGN PLANNERS ARCHITECTS & ENGINEERS	TAISEI CORPORATION
TAISEI	TAISEI CORPORATION
TAISEI CORPORATION DESIGN DIVISION	TAISEI CORPORATION
TAISEI DESIGN PAE	TAISEI CORPORATION
TAISEI DESIGN	TAISEI CORPORATION
TAISEI DESIGN PLANNERS ARCHITECTS AND ENGINEERS	TAISEI CORPORATION
TAISEI DESIGN ARCHITECTS & ENGINEERS	TAISEI CORPORATION
TAISEI DESIGN PLANNERS ARCHITECTS & ENGINEERS	TAISEI CORPORATION
TAISEI DESIGN PLANNERS ARCHITECTS&ENGINEERS	TAISEI CORPORATION


Tadao ando architects	TADAO ANDO ARCHITECT & ASSOCIATES
TADAO ANDO ARCHITECT&ASSOCIAT	TADAO ANDO ARCHITECT & ASSOCIATES
Tadao ando architectural institute (stage design)	TADAO ANDO ARCHITECT & ASSOCIATES
TADAO ANDO & ASSOCIATES	TADAO ANDO ARCHITECT & ASSOCIATES
TADAO ANDO ARCHITECTS & ASSOCIATES	TADAO ANDO ARCHITECT & ASSOCIATES
TOYO ITO & ASSOCIATES,ARCHITECTS	TOYO ITO & ASSOCIATES, ARCHITECTS
TOYO ITO&ASSOCIATES,ARCHITECTS	TOYO ITO & ASSOCIATES, ARCHITECTS
TOYO ITO & Associates, Architects	TOYO ITO & ASSOCIATES, ARCHITECTS

yasui architects & engineers, inc.	YASUI ARCHITECTS & ENGINEERS
Yasui architects	YASUI ARCHITECTS & ENGINEERS
YASUI ARCHITECTS AND ASSOCIATES	YASUI ARCHITECTS & ENGINEERS
YASUI ARCHITECT & ENGINEERS	YASUI ARCHITECTS & ENGINEERS
YASUI ARCHITECTS & ENGINEERING	YASUI ARCHITECTS & ENGINEERS

TOKYU SEKKEI CONSULTANT	TOKYU ARCHITECTS & ENGINEERS
Azusa Design	AZUSA SEKKEI
SHIGERU BAN, ARCHITECT	SHIGERU BAN ARCHITECTS
SHIGERU  BAN ARCHITECTS	SHIGERU BAN ARCHITECTS
Maki general planning office	MAKI AND ASSOCIATES
MAKI AND ASSOCIATES IN ASSOCIATION	MAKI AND ASSOCIATES
UR	URBAN RENAISSANCE AGENCY
ATELIER BOUW-WOW	ATELIER BOW-WOW

Kisho Kurokawa Architects & Urban Design Office	KISHO KUROKAWA ARCHITECT & ASSOCIATES
KISHO KUROKAWA ARCHITECT AND ASSOCIATES	KISHO KUROKAWA ARCHITECT & ASSOCIATES
KISYO KUROKAWA ARCHITECTS & ASSOCIATES	KISHO KUROKAWA ARCHITECT & ASSOCIATES
KISHO KUROKAWA Architects & Associates	KISHO KUROKAWA ARCHITECT & ASSOCIATES

SAKAKURA ASSOCIATES ARCHITECTS & ENGINEERS	SAKAKURA ASSOCIATES ARCHITECTS AND ENGINEERS
SAKAKURA ASSOCIATES	SAKAKURA ASSOCIATES ARCHITECTS AND ENGINEERS
SAKAKURA ASSOCIATES ARCHITECT & ENGINEERS	SAKAKURA ASSOCIATES ARCHITECTS AND ENGINEERS
sakakura architectural institute	SAKAKURA ASSOCIATES ARCHITECTS AND ENGINEERS
sakakura & associates	SAKAKURA ASSOCIATES ARCHITECTS AND ENGINEERS

ARATA ISOZAKI&Asoociates	ARATA ISOZAKI & ASSOCIATES
ARATA ISOZAKI ＆ Associates	ARATA ISOZAKI & ASSOCIATES
ARATA ISOZAKI and Associates architects	ARATA ISOZAKI & ASSOCIATES
Arata isozaki atelier	ARATA ISOZAKI & ASSOCIATES

NAITO ARCHITECTS & ASSOCIATES	NAITO ARCHITECT & ASSOCIATES
NAITO  ARCHITECT & ASSOCIATES	NAITO ARCHITECT & ASSOCIATES
NAITO ARCHITECT&ASSOCIATES	NAITO ARCHITECT & ASSOCIATES
HIROSHI NAITO/NAITO ARCHITECT & ASSOCIATES	NAITO ARCHITECT & ASSOCIATES

DAIKEN  SEKKEI	DAIKEN SEKKEI
DAIKEN ARCHITECTS ASSOCIATES	DAIKEN SEKKEI
DAIKEN SEKKEI, INC.	DAIKEN SEKKEI
DAIKEN ARCHITECTS ENGINEERS & CONSULTANTS	DAIKEN SEKKEI
DAIKEN Architects & Engineers	DAIKEN SEKKEI

RIA	RESEARCH INSTITUTE OF ARCHITECTURE

S. UCHII ARCHITACTS	S. UCHII ARCHITECT & ASSOCIATES
S.UCHII Architect and Associates	S. UCHII ARCHITECT & ASSOCIATES
S.UCHII ARCHITECTS	S. UCHII ARCHITECT & ASSOCIATES
SHOZO UCHII, Architect and Associates	S. UCHII ARCHITECT & ASSOCIATES
S UCIHI Architect & Associates	S. UCHII ARCHITECT & ASSOCIATES
UCHII ARCHITECT & ASSOCIATES	S. UCHII ARCHITECT & ASSOCIATES


SAKAKURA ASSOCIATES ARCHITECTS ARCHITECTS AND ENGINEERS	SAKAKURA ASSOCIATES ARCHITECTS AND ENGINEERS
SAKAKURA ASSOCIATES ARCH TECTS AND ENGINEERS	SAKAKURA ASSOCIATES ARCHITECTS AND ENGINEERS
SAKAKURA ASSOCIATES ARCHITECT AND ENGINEERS	SAKAKURA ASSOCIATES ARCHITECTS AND ENGINEERS
SAKAKURA ASSOCIATES ARCHITECTS & ENGINEERS	SAKAKURA ASSOCIATES ARCHITECTS AND ENGINEERS
SEIZO SAKATA	SAKAKURA ASSOCIATES ARCHITECTS AND ENGINEERS

TOHATA ARCHITECTS AND ENGINEERS	TOHATA ARCHITECTS & ENGINEERS
TOHATA & ASSOCIATES, ARCHITECTS	TOHATA ARCHITECTS & ENGINEERS
K. TOHATA & ASSOCIATES, ARCHITECTS	TOHATA ARCHITECTS & ENGINEERS

HISAO KOHYAMA ATELIER	KOHYAMA ATELIER
KOHYAMA ATEALIER	KOHYAMA ATELIER
KAJIMA	KAJIMA CORPORATION

toda construction	TODA CORPORATION

FUJIMORI TERUNOBU	TERUNOBU FUJIMORI

JUN AOKI&ASSOCIATES	JUN AOKI & ASSOCIATES

STUDIO ON	STUDIO ON SITE

MITSUBISHI ESTATE.CO.LTD. ARCHITECTURAL DESIGN & ENGINEERING OFFICE	MITSUBISHI ESTATE ARCHITECTURAL & ENGINEERING OFFICE
MITSUBISHI ESTATE CO., LTD.	MITSUBISHI ESTATE ARCHITECTURAL & ENGINEERING OFFICE
MITSUBISHI ESTATE	MITSUBISHI ESTATE ARCHITECTURAL & ENGINEERING OFFICE
ALSED	ARCHITECTURAL LABORATORY FOR SYSTEMS ENVIRONMENT DEVELOPMENT
ARCHITECTURAL LABORATORY FOR SYSTEMS， ENVIRONMENT  & DEVELOPMENT	ARCHITECTURAL LABORATORY FOR SYSTEMS ENVIRONMENT DEVELOPMENT
AL SED ARCHITECTURAL LABORATORY FOR SYSTEMS ENVIRONMENT DEVELOPMENT	ARCHITECTURAL LABORATORY FOR SYSTEMS ENVIRONMENT DEVELOPMENT
Alced Architectural Research Institute	ARCHITECTURAL LABORATORY FOR SYSTEMS ENVIRONMENT DEVELOPMENT
ALSED ARCHITECTURAL LABORATORY	ARCHITECTURAL LABORATORY FOR SYSTEMS ENVIRONMENT DEVELOPMENT
alced architectural institute	ARCHITECTURAL LABORATORY FOR SYSTEMS ENVIRONMENT DEVELOPMENT
arsed architectural institute	ARCHITECTURAL LABORATORY FOR SYSTEMS ENVIRONMENT DEVELOPMENT

Nomura co.	NOMURA

FUJITA	FUJITA CORPORATION

SHIMIZU ARCHITECTS AND ENGINEERS	SHIMIZU CORPORATION

KAZUYO SEJIMA＋RYUE NISHIZAWA／SANAA	KAZUYO SEJIMA + RYUE NISHIZAWA / SANAA
KAZUYO SEJIMA＋RYUE NISHIZAWA ／ SANAA	KAZUYO SEJIMA + RYUE NISHIZAWA / SANAA
KAZUYO SEJIMA＋RYUE NISHIZAWA / SANAA	KAZUYO SEJIMA + RYUE NISHIZAWA / SANAA
KAZUYO SEJIMA + RYUE NISHIZAWA / SANNA	KAZUYO SEJIMA + RYUE NISHIZAWA / SANAA
OBAYASHI CORPORATION ARCHITECTS AND ENGINEERS	OBAYASHI CORPORATION


NIKKEN SEKKEI Planners Architects & Engineers	NIKKEN SEKKEI
Nikken Sekkei Osaka	NIKKEN SEKKEI, OSAKA OFFICE
Nikken Sekkei, Osaka	NIKKEN SEKKEI, OSAKA OFFICE
Nikken sekkei osaka head office	NIKKEN SEKKEI, OSAKA OFFICE

SHIN'ICHI OKADA ARCHITECT AND ASSOCIATES	OKADA & ASSOCIATES
SHINICHI OKADA AND ASSOCIATES	OKADA & ASSOCIATES
SHINICHI AND ASSOCIATES	OKADA & ASSOCIATES
SHINICHI OKADA Architect & Associates	OKADA & ASSOCIATES
OKADA & ASSOCIATES	OKADA & ASSOCIATES
shinichi okada design office	OKADA & ASSOCIATES

Kenzo Tange Urban and Architectural Design Institute	KENZO TANGE ASSOCIATES
Kenzo Tange Institute of Urban and Architectural Design	KENZO TANGE ASSOCIATES
KENZO TANGE ASSOCIATES Urbanists-Architects	KENZO TANGE ASSOCIATES
KENZO TANGE ASSOCIATES URBANISTS - ARCHITECTS	KENZO TANGE ASSOCIATES

KAZUYO SEJIMA AND ASSOCIATES	KAZUYO SEJIMA & ASSOCIATES

RUI SEKKEISHITU	RUI SEKKEISHITSU

TEZUKA ARCHITECTS	TAKAHARU TEZUKA＋YUI TEZUKA／TEZUKA ARCHITECTS
OFFICE OF KUMIKO INUI	INUI ARCHITECTS

JUN MITSUI&ASSOCIATES	JUN MITSUI & ASSOCIATES ARCHITECTS
JUN MITSUI & ASSOCIATES	JUN MITSUI & ASSOCIATES ARCHITECTS
JUN MITSUI & ASSOCIATES ARCHITECTS	JUN MITSUI & ASSOCIATES ARCHITECTS
JUN MITSUI & ASSOCIATES INC ARCHITECTS	JUN MITSUI & ASSOCIATES ARCHITECTS
Jun Mitsui & Associates Inc. Architects	JUN MITSUI & ASSOCIATES ARCHITECTS
JUN MITSUI AND ASSOCIATES	JUN MITSUI & ASSOCIATES ARCHITECTS
NIKKEN SEKKEI Planners/Architects/Engineers	NIKKEN SEKKEI

MASAYA FUJIMOTO + GENDAI KEIKAKU ARCHITECTURAL PLANNING OFFICE	GENDAI KEIKAKU ARCHITECTURAL & PLANNING OFFICE
Gendai planning institute	GENDAI KEIKAKU ARCHITECTURAL & PLANNING OFFICE

HIROSHI HARA＋ATELIER Φ	HIROSHI HARA + ATELIERφ
HIROSHI HARA + ATELIER Φ	HIROSHI HARA + ATELIERφ
HIROSHI HARA+ATELIER	HIROSHI HARA + ATELIERφ
HIROSHI HARA ＋ ATELIER Φ	HIROSHI HARA + ATELIERφ
HIROSHI HARA＋Atelier φ	HIROSHI HARA + ATELIERφ
OSAMU ISHIYAMA Lab.DEPARTMENT OF ARCHITECTURE, WASEDA UNIVERSITY.	Shubu Ishiyama
Osamu Ishiyama	Shubu Ishiyama

MAKOTO SEI WATANABE / ARCHITECTS' OFFICE	MAKOTO SEI WATANABE/ ARCHITECTS' OFFICE
MAKOTO SEI WATANABE / ARCHITECTS OFFICE	MAKOTO SEI WATANABE/ ARCHITECTS' OFFICE
MAKOTO SEI WATANABE/ARCHITECTS' OFFICE	MAKOTO SEI WATANABE/ ARCHITECTS' OFFICE
MAKOTO WATANABE/Architects' Office	MAKOTO SEI WATANABE/ ARCHITECTS' OFFICE
MAKOTO WATANABE	MAKOTO SEI WATANABE/ ARCHITECTS' OFFICE
Architects Office Makoto Watanabe	MAKOTO SEI WATANABE/ ARCHITECTS' OFFICE

MITSURU SENDA	MITSURU SENDA + ENVIRONMENT DESIGN INSTITUTE
MITSURU SENDA ＋ ENVIRONMENT DESIGN INSTITUTE	MITSURU SENDA + ENVIRONMENT DESIGN INSTITUTE
MITSURU SENDAI AND ENIVIRONMENT DESIGN INSTITUTE	MITSURU SENDA + ENVIRONMENT DESIGN INSTITUTE
MITSURU SENDA AND ENVIRONMENT DESIGN INSTITUTE	MITSURU SENDA + ENVIRONMENT DESIGN INSTITUTE
MITSURU MAN SENDA AND ENVIRONMENT DESIGN INSTITUTE	MITSURU SENDA + ENVIRONMENT DESIGN INSTITUTE
MITSURU SENDA+E.D.I	MITSURU SENDA + ENVIRONMENT DESIGN INSTITUTE

NOMURA REAL ESTATE DEVELOPMENT ARCHITECTURAL DESIGN DEPT.	NOMURA REAL ESTATE DEVELOPMENT

ADH ARCHITECS	ADH ARCHITECTS
design organization adh	ADH ARCHITECTS
ATLIER HITOSHI ABE	ATELIER HITOSHI ABE
Noriaki okabe architecture network (design design)	NORIAKI OKABE ARCHITECTURE NETWORK

MHS PLANNERS， ARCHITECTS & ENGINEERS	MHS PLANNERS, ARCHITECTS & ENGINEERS
MHS PLANNERS, ARCHITECTS & ENGINEERS	MHS PLANNERS, ARCHITECTS & ENGINEERS
Consortium of MHS	MHS PLANNERS, ARCHITECTS & ENGINEERS
MHS PLANNERS, ARCHITECTS,ENGINEERS	MHS PLANNERS, ARCHITECTS & ENGINEERS
MHS Planner Architects & Engineers	MHS PLANNERS, ARCHITECTS & ENGINEERS

HASEKO CORPORATION ARCHITECTURE&ENGINEERING DEPT.	HASEKO CORPORATION

KENJI NAWA／NAWAKENJIM	KENJI NAWA / NAWAKENJI-M
KENJI NAWA/NAWAKENJI-M	KENJI NAWA / NAWAKENJI-M

Nippon Design Office	Japan Design Office
NIHON Architects, Engineers & Consultants	Japan Design Office

DATICH KOBO ASSOCIATES	DAIICHI-KOBO ASSOCIATES
Dai-Ichi Kobo	DAIICHI-KOBO ASSOCIATES
First Workshop	DAIICHI-KOBO ASSOCIATES

Riken yamamoto design factory	RIKEN YAMAMOTO & FIELD SHOP

Kokken	KUNIKEN
national construction	KUNIKEN
ARCHITECT ５ PARTNERSHIP	ARCHITECT 5 PARTNERSHIP

ISOZAKI ARATA	ARATA ISOZAKI

NISSOKEN ARCHITECTS／ENGINEERS	NISSOKEN ARCHITECTS/ENGINEERS
NISSOUKEN	NISSOKEN ARCHITECTS/ENGINEERS

NORIHIKO DAN ASSOCIATES	NORIHIKO DAN AND ASSOCIATES

EAST JAPAN RAILWAY	EAST JAPAN RAILWAY COMPANY

KLEINI DYTHAM ARCHITECTURE	KLEIN DYTHAM ARCHITECTURE
KLEIN DYTHAM ARCITECTURE	KLEIN DYTHAM ARCHITECTURE

HIROFUMI OHNO／OHNO JAPAN	HIROFUMI OHNO / OHNO JAPAN
OHNO JAPAN	HIROFUMI OHNO / OHNO JAPAN

TODA CORPORATION ARCHITECTURAL DESIGN DIVISION	TODA CORPORATION
TODA CORPORATION ARCHITECTURAL DESIGN DEPT	TODA CORPORATION
TODA CORPORATION ARCHITECTURAL DESIGN	TODA CORPORATION

DAIWA HOUSE INDUSTRY CO.LTD	DAIWA HOUSE INDUSTRY

Kume Architectural Office	KUME ARCHITECTS
KUME Architects-Engineers	KUME ARCHITECTS
kume & associates	KUME ARCHITECTS

MAYEKAWA ASSOCIATES ARCHITECTS & ENGINEERS	MAYEKAWA ASSOCIATES, ARCHITECTS & ENGINEERS
MAYEKAWA ASSOCIATES,ARCHITECTS & ENGINEERS	MAYEKAWA ASSOCIATES, ARCHITECTS & ENGINEERS
MAYEKAWA Associates and Engineers	MAYEKAWA ASSOCIATES, ARCHITECTS & ENGINEERS
Maekawa architects & engineers	MAYEKAWA ASSOCIATES, ARCHITECTS & ENGINEERS
MAEKAWA ASSOCIATES AND ENGINEERS	MAYEKAWA ASSOCIATES, ARCHITECTS & ENGINEERS

IRIE MIYAKE ARCHITECTS & ASSOCIATES	IRIE MIYAKE ARCHITECTS & ENGINEER
Irie Miyake Design Office	IRIE MIYAKE ARCHITECTS & ENGINEER

NIKKEN SEKKEL	NIKKEN SEKKEI
TAKENAKA CORPORATION TOKYO HEAD OFFICE	TAKENAKA CORPORATION

MITSUBISHI-JISHO-SEKKEI	MITSUBISHI JISHO SEKKEI
MITSUBISHI JISHO SEKKEI INC	MITSUBISHI JISHO SEKKEI
MITSUBISHI JISHO SEKKEI INC.	MITSUBISHI JISHO SEKKEI
MITSUBISHI JISHO	MITSUBISHI JISHO SEKKEI


NIKKEN SEKKEI, PLANNERS, ARCHITECTS AND ENGINEERS	NIKKEN SEKKEI
NIHON SEKKEI,INC.	NIHON SEKKEI
TAISEI CORPORATION DESIGN DEPARTMENT	TAISEI CORPORATION
OBAYASHI CORP. ARCHITECTURAL & ENGINEERING DIVISION	OBAYASHI CORPORATION
OBAYASHI CORPORATION HEAD OFFICE, FIRST-CLASS ARCHITECT OFFICE	OBAYASHI CORPORATION
YAMASHITA SEKKEI, ARCHITECTS, ENGINEERS & CONSULTANTS	YAMASHITA SEKKEI
NTT FACILITIES INC.	NTT FACILITIES
ISHIMOTO ARCHITECTURAL AND ENGINEERING FIRM	ISHIMOTO ARCHITECTURAL & ENGINEERING FIRM
ISHIMOTO ARCHITECTURAL&ENGINEERING FIRM	ISHIMOTO ARCHITECTURAL & ENGINEERING FIRM
ISHIMOTO ARCHITECTURAL & ENGINEERING FIRM(BASIC DESIGN)	ISHIMOTO ARCHITECTURAL & ENGINEERING FIRM
TOYO ITO & ASSOCIATES	TOYO ITO & ASSOCIATES, ARCHITECTS
TOYO ITO & ASSOCIATES, ARCHITECT	TOYO ITO & ASSOCIATES, ARCHITECTS
TOYO ITO &  ASSOCIATES, ARCHITECTS	TOYO ITO & ASSOCIATES, ARCHITECTS
TOYO ITO&ASSOCIATES, ARCHITECTS	TOYO ITO & ASSOCIATES, ARCHITECTS
OSAKA OFFICE, SAKAKURA ARCHITECTS & ENGINEERS	SAKAKURA ARCHITECTS & ENGINEERS OSAKA OFFICE
AZUSA SEKKEI ARCHITECTS ENGINEERS & CONSULTANTS	AZUSA SEKKEI
KISHO KUROKAMJA	KISHO KUROKAWA ARCHITECT & ASSOCIATES
KISHO KUROKAWA	KISHO KUROKAWA ARCHITECT & ASSOCIATES
SHIGERU BAN ARCHITECTS TOKYO	SHIGERU BAN ARCHITECTS
KAJIMA CORPORATION ARCHITECTURAL DESIGN DIVISION	KAJIMA CORPORATION
ARATA ISOZAKI & ASSOCIATES, ARCHITECT	ARATA ISOZAKI & ASSOCIATES
PLACEMEDIA LANDSCAPE ARCHITECTS COLLABORATIVE	PLACEMEDIA
DESIGN ORGANIZATION PLACEMEDIA	PLACEMEDIA
FUJITA KOGYO	FUJITA CORPORATION
MHS PLANNERS ARCHITECTS & ENGINEERS	MHS PLANNERS, ARCHITECTS & ENGINEERS
HIROSHI HARA+ATELIER Φ	HIROSHI HARA + ATELIERφ
HIROSHI HARA + ATELIERΦ	HIROSHI HARA + ATELIERφ
JUNAOKI & ASSOCIATES	JUN AOKI & ASSOCIATES
ARCHITECTURAL LABORATORY FOR SYSTEMS, ENVIRONMENT  & DEVELOPMENT	ARCHITECTURAL LABORATORY FOR SYSTEMS ENVIRONMENT DEVELOPMENT
TETSUO FURUICHI & ASSOCIATES	FURUICHI & ASSOCIATES
ARCHITECT 5 PERTNERS	ARCHITECT 5 PARTNERSHIP
TAKAHARU TEZUKA＋YUI TEZUKA／TEZUKA ARCHITECTS	TAKAHARU TEZUKA＋YUI TEZUKA/TEZUKA ARCHITECTS
MORI BUILDING CO,LTD	MORI BUILDING
HIROSHI NAKAMURA & NAP	HIROSHI NAKAMURA&NAP
MITSURU SENNDA+ENVIRONMENNT DESIGN INSTITUTE	MITSURU SENDA + ENVIRONMENT DESIGN INSTITUTE
WORK STATION	WORKSTATION
KENJI NAWA/NAWAKENJIM	KENJI NAWA / NAWAKENJI-M
OBAYASHI CORPORATON	OBAYASHI CORPORATION
AZUSA SEKEI	AZUSA SEKKEI
S UCHII ARCHITECT & ASSOCIATES	S. UCHII ARCHITECT & ASSOCIATES
ISHIMOTO ARCHITECTURAL AND ENGINEERING FIRM,	ISHIMOTO ARCHITECTURAL & ENGINEERING FIRM
ISHIMOTO ARCHITECTURAL & ENGINEERING FIRM,INC	ISHIMOTO ARCHITECTURAL & ENGINEERING FIRM
SAKAKURA ASSOCIATES AND ENGIEERS	SAKAKURA ASSOCIATES ARCHITECTS AND ENGINEERS
SAKAKURA ASSOCIATES, ARCHITECTS & ENGINEERS	SAKAKURA ASSOCIATES ARCHITECTS AND ENGINEERS
LOUIS VUTTON MALLETIER	LOUIS VUITTON MALLETIER
NAP ARCHITECTS, INC.	NAP ARCHITECTS

NTT-URBAN DEVELOPMENT	NTT URBAN DEVELOPMENT
TOKYU CORPORAION	TOKYU CORPORATION
MAEKAWA KUNIO ARCHITECTS & ENGINEERS	KUNIO MAEKAWA ARCHITECTS & ENGINEERS
TEAMZOO ATELIER IRUKA	TEAM ZOO ATELIER IRUKA
TEAM ZOO/ATELIER IRUKA	TEAM ZOO ATELIER IRUKA
TEAM ZOO IRUKA DESIGN GROUP	TEAM ZOO ATELIER IRUKA
SHOICHI HARYU ARCHITECTS & ASSOCIATES	SHOICHI HARYU ARCHITECT & ASSOCIATES
NTT URBAN DEVELOPMENT CO.	NTT URBAN DEVELOPMENT
HIROSHI OHNO / OHNOJAPAN	HIROFUMI OHNO / OHNO JAPAN

K. SONE & ENVIRONMENTAL DESIGN ASSOCIATES	K.SONE&ENVIRONMENTAL DESIGN ASSOCIATES
K.SONE ENVIOROMENTAL DESIGN ASSOCIATES	K.SONE&ENVIRONMENTAL DESIGN ASSOCIATES

SHOICHI HARIU ARCHITECTS & ASSOCIATES	SHOICHI HARYU ARCHITECT & ASSOCIATES
SYOICHI HARIU ARCHITECT & ASSOCIATES	SHOICHI HARYU ARCHITECT & ASSOCIATES
SHOICHI HARYU ARCHITECT & ASSOCIATE	SHOICHI HARYU ARCHITECT & ASSOCIATES
SPATIAL RESEARCH INSTITUTE	SPATIAL DESIGN STUDIO

MASAHIRO IKEDA ARCHITECTURE STUDIO CO LTD	MASAHIRO IKEDA ARCHITECTURE STUDIO

AZUMA ARCHITECT & ASSOCIATES, STUDIO ON SITE	AZUMA ARCHITECT & ASSOCIATES

KAZUHIRO KOJIMA + KAZUKO AKAMATSU/ CA	KAZUHIRO KOJIMA+KAZUKO AKAMATSU / CAT
KAZUHIRO KOJIMA+KAZUKO AKAMATSU/CA	KAZUHIRO KOJIMA+KAZUKO AKAMATSU / CAT
KAZUHIRO KOJIMA + KAZUKO AKAMATSU / CAT	KAZUHIRO KOJIMA+KAZUKO AKAMATSU / CAT
KAZUHIRO KOJIMA + KAZUKO AKAMATSU / CAT	KAZUHIRO KOJIMA+KAZUKO AKAMATSU / CAT
KAZUHIRO KOJIMA+KAZUKO AKAMATSU/CAT	KAZUHIRO KOJIMA+KAZUKO AKAMATSU / CAT

NAWAKENJIM	NAWAKENJI-M
BLUESTUDIO	BLUE STUDIO
TEAM TIMBERLISE	TEAM TIMBERIZE

KISABURO ITO ARCHITECTS	K.ITO ARCHITECTS & ENGINEERS
ASHIHARA ARCHITECTURAL DESIGN INSTITUTE	Y.ASHIHARA ARCHITECT & ASSOCIATES

HITACHI ARCHITECTS AND ENGINEERS	HITACHI ARCHITECTS & ENGINEERS
SUZUKI EDWARD ARCHITECTS	EDWARD SUZUKI ASSOCIATES

ATSUSHI KITAGAWARA ARCHITECTS INC.	ATSUSHI KITAGAWARA ARCHITECTS
HITOSHI WAKAMATSU ARCHITECTS	HITOSHI WAKAMATSU ARCHITECT AND ASSOCIATE
NOBUAKI FURUYA+NASCA	NOBUAKI FURUYA/NASCA

KOHN PEDERSEN FOX ASSOCIATES PC	KOHN PEDERSEN FOX ASSOCIATES

SUMITOMO MITSUI CONSTRUCTION CO., LTD.	SUMITOMO MITSUI CONSTRUCTION
SUMITOMO MITSUI CONSTRUCTION CO.	SUMITOMO MITSUI CONSTRUCTION

TOKYO INSTITUTE OF TECHNOLOGY TSUKAMOTO LABORATORY+ATELIER BOW-WOW	MOUNT FUJI ARCHITECTS STUDIO

MASATAKA BABA, YUKI HIRALWA./OPEN A	MASATAKA BABA + YUKI HIRAIWA / OPEN A

ZO DESIGN GROUP	ATELIER ZO
ELEPHANT DESIGN GROUP	ATELIER ZO
ALP DESIGNERS	ALP DESIGN OFFICE
ALP DESIGN OFFICE.	ALP DESIGN OFFICE
KUNIHIKO HAYAKAWA ARCHITECT&ASSOCIATES	KUNIHIKO HAYAKAWA ARCHITECT & ASSOCIATES
CONTEMPORARY ARCHITECTURE INSTITUTE	GKK ARCHITECTS & ENGINEERS

SHIN TAKAMATSU ARCHITECT & ASSOCIATES	SHIN TAKAMATSU ARCHITECT AND ASSOCIATES
SHIN TAKAMATSU ARCHITECT AND ASSOCIATES CO.,LTD.	SHIN TAKAMATSU ARCHITECT AND ASSOCIATES
NOMURA KANEEO DESIGN OFFICE	KANEO NOMURA ARCHITECT & ASSOCIATES
KOGAWA ARCHITECTS & ENGINEERS, INC.	OGAWA ARCHITECTS & ENGINEERS

URABE SEKKEL	URABESEKKEI

MARIO BELLINI ASSOCIATE	MARIO BELLINI
MAKOTO NOZAWA + GETT	MAKOTO NOZAWA+GETT
SHINICHI OGAWA & ASSOCIATES / URBANIST ARCHITECT	SHINICHI OGAWA & ASSOCIATES
SOUSUKE FUJIMOTO	SOU FUJIMOTO
ENDO DESIGN HOUSE	ENDOH DESIGN HOUSE
TADASU OHE/PLANTEC ARCHITECTS	TADASU OHE / PLANTEC ARCHITECTS
TRAF ARCHITECTS	TORAFU ARCHITECTS
INSTITUTE OF MODERN ARCHITECTURE	MODERN ARCHITECTURE INSTITUTE

SUSUMU UNO/CAN	SUSUMU UNO / CAN
DP A	DP ARCHITECTS
TAISEI CORPORARION	TAISEI CORPORATION
MITSUBUSHI JISHO SEKKEI	MITSUBISHI JISHO SEKKEI
NTT FACIRITIES	NTT FACILITIES
AXA SATOW	AXS SATOW
KUME SKKKEI	KUME SEKKEI

ISHIMOTO ARCHITECTURAL & ENGENEERING FIRM	ISHIMOTO ARCHITECTURAL & ENGINEERING FIRM

JR-EAST DESIGN CORPORATION	JR EAST DESIGN CORPORATION
SAKAKURA ASSOSIATES ARCHITECTS AND ENGINEERS	SAKAKURA ASSOCIATES ARCHITECTS AND ENGINEERS
FURICHI & ASSOCIATES	FURUICHI & ASSOCIATES


KIYOSI SEI TAKEYAMA+ AMORPHE	KIYOSHI SEY TAKEYAMA +AMORPHE
COELACANTH ARCHITECTS INC.	COELACANTH ARCHITECTS
MITSUO YOKOSUKA ARCHITECTURAL CO., LTD	MITSUO YOKOSUKA ARCHITECTURAL CO., LTD.

SHINICHI OGAWA & ASSOCIATES URBANIST ARCHITECT	SHINICHI OGAWA & ASSOCIATES
KAZUO WATABE / YUI ARCHITECTS & PLANNERS	KAZUO WATABE/YUI ARCHITECTS & PLANNERS

JUNYA.ISHIGAMI+ASSOCIATES	JUNYA ISHIGAMI+ASSOCIATES
JUNYA.ISHIGAMI+ASSOCIATES	JUNYA ISHIGAMI+ASSOCIATES
JUNYA.ISHIGAMI ASSOCIATES	JUNYA ISHIGAMI+ASSOCIATES
JO NAGASAKA/SCEHMATA ARCHITECTS	JO NAGASAKA/SCHEMATA ARCHITECTS

KANAGAWA UNIVERSITY SOGABE LABORATORY	SOGABE LABORATORY, KANAGAWA UNIVERSITY
CONTEMPORARIES/JUN YANAGISAWA	JUN YANAGISAWA/CONTEMPORARIES
JUN YANAGISAWA / CONTEMPORARIES	JUN YANAGISAWA/CONTEMPORARIES
VOLUNTARY ARCHITECTS’ NETWORK(VAN)	VOLUNTARY ARCHITECTS’NETWORK (VAN)
VOLUNTARY ARCHITECTS NETWORK	VOLUNTARY ARCHITECTS’NETWORK (VAN)
YUZURU TOMINAGA+FORMSYSTEM INSTITUTES	YUZURU TOMINAGA+FORM SYSTEM INSTITUTE

KAZUHIRO ISII ARCHITECT & ASSOCIATES	KAZUHIRO ISHII ARCHITECT & ASSOCIATES
TAKASHI SUGIYAMA ARCHITECTS & ENGINEERS	TAKASHI SUGIYAMA ARCHITECT AND ASSOCIATES
OSAKI CAMPUS REDEVELOPMENT PROJECT, RISSHO UNIVERSITY	MASAO SHIINA Architects

HIROSHI OE ARCHITECTS & ASSOCIATES	HIROSHI OHE, ARCHITECT AND ASSOCIATES
SAGA WAKO	WAKO SAGA
ATSUICHI YOSHIMURA / INSTITUTE FOR BUILT ENVIRONMENT	TOKUICHI YOSHIMURA + INSTITUTE FOR BUILT ENVIRONMENT
ATSUICHI YOSHIMURA + INSTITUTE FOR BUILT ENVIRONMENT	TOKUICHI YOSHIMURA + INSTITUTE FOR BUILT ENVIRONMENT

YUZURU TOMINAGA+ FORM SYSTEM INSTITUTE	YUZURU TOMINAGA + FORM SYSTEM INSTITUTE
KITAMURA ASSOCIATES, INC.	KITAMURA ASSOCIATES
ALCOM	ARCOM
RAYMOND ARCHITECTURAL DESIGN OFFICE, INC.	RAYMOND ARCHITECTURAL DESIGN OFFICE
SACHIO OTANL	SACHIO OTANI

ENVIRONMENTAL DEVEROPMENT RESEARCH INC.	ENVIRONMENTAL DEVELOPMENT RESEARCH
ENVIRONMENTAL DEVEROPMENT RESEARCH	ENVIRONMENTAL DEVELOPMENT RESEARCH
ARTSTATION	ART STATION

KENCHIKU DESIGN STUDIO,TOKYO	KENCHIKU DESIGN STUDIO

KENCHIKU DESIGN STUDIO, TOKYO	KENCHIKU DESIGN STUDIO
DENTON CORKER MARSHALL PTY.,LTD.	DENTON CORKER MARSHALL

YASUTAKA YAMAZAKI+ AZ INSTITUTE YAMAZAKI SHISA INSTITUTE	YASUTAKA YAMAZAKI+AZ INSTITUTE
KATSUHIRO KOBAYASHI + DESIGN STUDIO ARCHITECTS	KATSUHIRO KOBAYASHI + DESIGN STUDIO

HIDETOSHI OHNO+ARCHITECTS&PLANNERS LEAGUE	HIDETOSHI OHNO,ARCHITECTS & PLANNERS LEAGUE

HIDETOSHI OHNO+ARCHITECTS PLANNERS LEAGUE	HIDETOSHI OHNO,ARCHITECTS & PLANNERS LEAGUE

TOMOHIKO SHIBATA SKM ARCHITECTS & PLANNERS	TOMOHIKO SHIBATA. SKM ARCHITECTS & PLANNERS
HISAO KOYAMA ATELIER	KOYAMA ATELIER
DAI NAGASAKA/MEGA	DAI NAGASAKA/MÉGA

HIROFUMI SUGIMOTO KEIKAKU	HIROFUMI SUGIMOTO/KEIKAKU
HIROFUMI SUGIMOTO/KEIKAKU INC.	HIROFUMI SUGIMOTO/KEIKAKU

MITSUBISHI HEAVY INDUSTORY	MITSUBISHI HEAVY INDUSTRIES
INSTITUTE OF NEW ARCHITECUTURE	INSTITUTE OF NEW ARCHITECTURE

SHIN TAKAMATSU + SHIN TAKAMATSU ARCHITECT & ASSOCIATES	SHIN TAKAMATSU + SHIN TAKAMATSU ARCHITECT AND ASSOCIATES

SHUHEI ENDO	ENDO SHUHEI ARCHITECT INSTITUTE
SHUHEI ENDO ARCHITECTS INSTITUTE	ENDO SHUHEI ARCHITECT INSTITUTE
MARUNOUCHI ARCHITECTS AND ENGINEERS	MARUNOUCHI ARCHITECTS & ENGINEERS

KYUSHU RAILWAYCOMPANY	KYUSHU RAILWAY COMPANY
JAPANESE ASSOCIATION FOR CONSERVATION OF ARCHITECTURAL MONUMENTS	THE JAPANESE ASSOCIATION FOR CONSERVATION OF ARCHITECTURAL MONUMENTS
IMAMURA MASAKI ARCHITECTS	MASAKI IMAMURA ARCHITECTS

TOKYO INSTITUTE OF TECHNOLOGY TSUKAMOTO LABOR	TOKYO INSTITUTE OF TECHNOLOGY TSUKAMOTO LABORATORY

KASUHIRO KOJIMA / C+A	KAZUHIRO KOJIMA / C+A
URVAN DESIGN CORPORATION	URBAN DESIGN CORPORATION
HERZOG & DE MEURON	HERZOG&DE MEURON

KEIKAKU INC.	KEIKAKU
GAET AULENTI	GAE AULENTI

HIDEO SATSUTA / SATSUTA STUDIO OF ARCHITECTURE, DAY-CARE CENTER, WATARI TOWN	HIDEO SATSUTA / SATSUTA ARCHITECT STUDIO
RYUJI NAKAMURA AND ASSOCIATES	RYUJI NAKAMURA & ASSOCIATES

TETSUO KONDO ARCHITECS	TETSUO KONDO ARCHITECTS

ONISHI MAKI + HYAKUDA YUKI ARCHITECTS / O+H	ONISHIMAKI+HYAKUDAYUKI ARCHITECTS/O+H
TAIYO KOGYO CORPORATION	TAIYO KOGYO
YOKOGAWA ARCHITECT & ASSOCIATES	KEN YOKOGAWA ARCHITECT & ASSOCIATES

FUJIWALABO + MISAWA HOME	FUJIWALABO
PETER MARINO ARCHITECT,	PETER MARINO ARCHITECT

ALPHAVILLE ARCHITECTS/ KENTARO TAKEGUCHI+ASAKO YAMAMOTO	ALPHAVILLE ARCHITECTS / KENTARO TAKEGUCHI + ASAKO YAMAMOTO

NAKA ARCHITECTS’ STUDIO	NAKA ARCHITECTS' STUDIO
RHYTHM DESIGN	RHYTHMDESIGN
IKIMONOARCHITECTS	IKIMONO ARCHITECTS
TSUTOMU ABE/ALTEC ARCHITECTS & ENGINEERS, INC.	TSUTOMU ABE/ARTEC ARCHITECTS & ENGINEERS, INC.

RESEARCH INSTITUTE OF SCIENIC & TECHNOLOGY NIHON UNIV	RESEARCH INSTITUTE OF SCIENCE & TECHNOLOGY NIHON UNIV

SHOEI YOH + ARCHITECTS	SHOEI YOH+ARCHITECTS
KENSUKE YOSHIDA, ARCHITECT & ASSOCIATES	KENSUKE YOSHIDA ARCHITECT & ASSOCIATES
TEAM ZOO ELEPHANT DESIGN GROUP	TEAM ZOO ATELIER ZO

SHOYA UCHIDA	YOSHICHIKA UCHIDA
HIROSI HARA+ATELIERΦ	HIROSHI HARA + ATELIER PHI
TAKENAKA CORPORATION OSAKA HEAD OFFICE DESIGN DEPARTMENT	TAKENAKA CORPORATION OSAKA HEAD OFFICE
QINGDAO DESIGN	AOSHIMA DESIGN
YOSHIAKI TADA ARCHITECT & ASSOCIATES	YOSHIAKI TADA ARCHITECT AND ASSOCIATES
KEIZO MATSUBARA	KEIZO MATSUMURA
OOBA	OHBA
HOSOGI ARCHITECT & ASSOCIATE	HOSOGI ARCHITECT & ASSOCIATES
CAZATEC	CASATEC
ORGANIZATION OF YOKOHAMA CITY GOVERNMENT TADASU OHE/PLANTEC	TADASU OHE/PLANTEC
TOHRU FUNAKOSHI + ARCOM R&D.	TOHRU FUNAKOSHI + ARCOM R&D,ARCHITECTS
OHBAYASHI CORPORATION	OBAYASHI CORPORATION
ANDRE WOJANSKI	ANDRÉ WOGENSCKY
FUJIKI CORPORATION	FUJIKI KOMUTEN

KIMURA HIROAKI / KS ARCHITECTS	KIMURA HIROAKI/KS ARCHITECTS
RENZO PIANO-PARIS	RENZO PIANO

TAK ASSOCIATED ARCHITECTS INC.	TAK ASSOCIATED ARCHITECTS
JAPAN AIRPORT CONSULTS	JAPAN AIRPORT CONSULTANTS
FUJINO SATO	FUJIO SATO
HAJIMEYATSUKA+UPM(URBAN PROJECT MACHINE)	HAJIME YATSUKA+UPM
F HASHIMOTO & URBANISTS	F. HASHIMOTO & URBANISTS
TESHIGAWARAHIROSHI	HIROSHI TESHIGAWARA
MORIS ADJIMI,PROGETTO CAPPA	MORRIS ADJMI
YOSHIHIRO MASKO	YOSHIHIRO MASUKO

TOTALMEDIA DEVELOPMENT INSTITUTE	TOTAL MEDIA DEVELOPMENT INSTITUTE
U ARCHITECTS	U-ARCHITECTS
ACT PLANNNING	ACT PLANNING
AKIRA YONEDA / ARCHITECTION	AKIRA YONEDA / ARCHITECTON
NAKAKO ARCHITECT & ENVIROMENT DESIGN	NAKAKO ARCHITECT & ENVIRONMENT DESIGN
THE JERDE PARTNER SHIP INTERNATIONAL	THE JERDE PARTNERSHIP INTERNATIONAL
JARDI PARTNERSHIP	THE JERDE PARTNERSHIP INTERNATIONAL
CITY OF KOBE HOUSING BUREAU PUBLIC BUILDING DEPARTMENT. TSUTOMU SHIGEMURA +TEAM 200 ATELIER RUKA	TSUTOMU SHIGEMURA

SAKAKURA ASSOCIATES, ARCHITECTS &ENGINEERS	SAKAKURA ASSOSIATES ARCHITECTS AND ENGINEERS
HOUSING & URBAN DEVELOPMENT CORP.	HOUSING & URBAN DEVELOPMENT CORPORATION

IZUMI SOKEN ENGINEERING	IZUMI SOHKEN ENGINEERING
IZUMISO-KEN ENGINEERING	IZUMI SOHKEN ENGINEERING

TOSHIAKI ISHIDA ARCHITECT & ASSOCIATES	TOSHIAKI ISHIDA ARCHITECT&ASSOCIATES
ONITAKE ROKKAKU	KIJO ROKKAKU
MANASARCHITECTS & ASSOCIATES	MANAS ARCHITECTS & ASSOCIATES
ANDO ARCHITECTUAL DESIGN OFFICE	ANDO ARCHITECTURAL DESIGN OFFICE

WARO KISHI+K.ASSOCIATES/ ARCHITECTS	WARO KISHI+K.ASSOCIATES/ARCHITECTS
ARCHITECTUERAL DESIGN & RESEARCH INSTITUTE OF TONGJI UNIVERASITY	ARCHITECTURAL DESIGN & RESEARCH INSTITUTE OF TONGJI UNIVERASITY

MANABU NAYA+ARATA NAYA/NAYA ARCHITECTS	MANABU NAYA + ARATA NAYA / NAYA ARCHITECTS

PCP DESIGN(NIKKEN+TAKENAKA)	PCP DESIGN TEAM(NIKKEN+TAKENAKA)
AKIO MURAKAMI ATELIER ARCHITECTS AND ASSOCIATES	AKIKO MURAKAMI ATELIER ARCHITECTS AND ASSOCIATES
OBAYASHI CORPORRATION TOKYO OFFICE,FIRST-ARCHITECT OFFICE	OBAYASHI CORPORATION TOKYO OFFICE,FIRST-ARCHITECT OFFICE

TAKAMATSU ARCHITECTS AND ASSOSIATES	TAKAMATSU ARCHITECTS AND ASSOCIATES
NIHON UNIVERSITY CENTRAL ADMINISTRATION OFFICE,OFFICE OF PROPERTY CUSTODY	NIHON UNIVERSITY CENTRAL ADMINISTRATION OFFICE, OFFICE OF PROPERTY CUSTODY

CHITOSHI KIHARA ARCHITECT & ASSOCIATES	CHITOSHI KIHARA ARCHITECT AND ASSOCIATES
JUN VERA + RYUJI FUJIMURA / ISSHO	JUN VERA+RYUJI FUJIMURA/ISSHO
ATERIER TEKUTO	ATELIER TEKUTO
SHOZO UCHII + UCHII ARCHITECTS	SHOZO UCHII+UCHII ARCHITECTS
KURASAKI KENCHIKU S.C.	KURASHIKI KENCHIKU S.C.
ATSUSHI YAGI ARCHITECTS & ASSOCIATE	ATSUSHI YAGI ARCHITECTS&ASSOCIATES
OSAMU MORISHITA, ARCHITECTS & ASSOCIATES	OSAMU MORISHITA ARCHITECT & ASSOCIATES
GO HASEGAWA & ASSOCIATES	GO HASEGAWA AND ASSOCIATES
URBAN DESIGN TEAM, HOUSING MANAGEMENT DEPARTMENT, URBAN RENAISSANCE AGENCY	URBAN DESIGN TEAM AND HOUSING MANAGEMENT DEPARTMENT, URBAN RENAISSANCE AGENCY
TAKASAGO THERMAL ENGINEERING CO.,LTD	TAKASAGO THERMAL ENGINEERING
DOMINIQUE  PERRAULT ARCHITECTURE	DOMINIQUE PERRAULT ARCHITECTURE
MITSUI FUDOUSAN RESIDENTIAL	MITSUI FUDOSAN RESIDENTIAL
THE ARCHITECTURAL DESIGN &, RESEARCH INSTITUTE OF GUANGDONG PROVINCE	THE ARCHITECTURAL DESIGN & RESEARCH INSTITUTE OF GUANGDONG PROVINCE
ON DESIGN PARTNERS	ONDESIGN PARTNERS
ICHINOURA	ICHIURA

YASUHIRO YAMASHITA×ATELIER TEKUTO	YASUHIRO YAMASHITA ATELIER TEKUTO
YASUHIRO YAMASHITA × ATELIER TEKUTO	YASUHIRO YAMASHITA ATELIER TEKUTO
JUN SATO STRUCTUAL ENGINEERS	JUN SATO STRUCTURAL ENGINEERS
"ITSURO HOSHIDA ARCHITECTS OFFICE\"""	ITSURO HOSHIDA ARCHITECTS OFFICE
+ NEW OFFICE	+NEW OFFICE

TAKANORI KAGAWA+JUNKO KISHIGAMI / SPACESPACE	TAKANORI KAGAWA+JUNKO KISHIGAMI/SPACESPACE

TETUYA NAKAZONO / NAF ARCHITECT & DESIGN	TETSUYA NAKAZONO / NAF ARCHITECT & DESIGN
SUPERVISION: CAMPUS DESIGN RECONSTRUCTION PROMOTION OFFICE, GRADUATE SCHOOL OF ENGINEERING, TOHOKU UNIVERSITY	CAMPUS DESIGN RECONSTRUCTION PROMOTION OFFICE, GRADUATE SCHOOL OF ENGINEERING, TOHOKU UNIVERSITY
KOIZUMI ATLIER	KOIZUMI ATELIER
DAIJU ARCHITECTS & ASSOCIATEES	DA-JU ARCHITECTS & ASSOCIATES
THE ZENITAKA CORPORATION	ZENITAKA CORPORATION
SOKENCONSULTANT	SOKEN CONSULTANT
HIROTO SUZUKI. ARCHITECTS & ASSOCIATES	HIROTO SUZUKI ARCHITECTS & ASSOCIATES
STUDIO TAU SHIMIZU	STUDIO TAKU SHIMIZU
KOTO ARCHITECTS AND ASSOCIATES	KATO ARCHITECTS AND ASSOCIATES
UNIVERSITY OF TOKYO	THE UNIVERSITY OF TOKYO
TOKYO UNIVERSITY OF SCIENCE  TAKU SAKAUSHI LABORATORY	TOKYO UNIVERSITY OF SCIENCE TAKU SAKAUSHI LABORATORY
TOKEN C.E.CONSULTANTS	TOKEN C.E.E.CONSULTANTS
KAJIMA DESIGNHIROSHI NAITO	HIROSHI NAITO
TOMOYUKI TANAKA LAB.,KUMAMOTO UNIVERSITY	TOMOYUKI TANAKA LAB., KUMAMOTO UNIVERSITY

METRO DEVEROPMENT	METRO DEVELOPMENT
TAK SAKAUSHI+O.F.D.A.	TAKU SAKAUSHI+O.F.D.A.
MASKO ATERIER	MASUKO ATERIER
KAZUKO AKAMATSU + SHINYA OMURA/CAT	KAZUKO AKAMATSU+SHINYA OMURA/CAT
PEAKSTUDIO	PEAK STUDIO
TOMOHIRO HATA ARCHITECTS & ASSOCIATES	TOMOHIRO HATA ARCHITECT & ASSOCIATES
KIYO TAKEDA ARCHITECTS	KIYOAKI TAKEDA ARCHITECTS
TATENAKA CORPORATION	TAKENAKA CORPORATION
SHIMIZU CORPORATION DESIGN DEVISION	SHIMIZU CORPORATION DESIGN DIVISION
GKK ARCHITECTS &  ENGINEERS	GKK ARCHITECTS & ENGINEERS
SHIRAE-ASSOCIATES	SHIRAE ASSOCIATES
KAZUHIRO KOJIMA/ C+A	KAZUHIRO KOJIMA / C+A
SOGABE LABORATORY,KANAGAWA UNIVERSITY	SOGABE LABORATORY, KANAGAWA UNIVERSITY
JO NAGASAKA / SCHEMATA ARCHITECTS	JO NAGASAKA/SCHEMATA ARCHITECTS
MISAKI DESIGN &ARCHITECTS OFFICE	MISAKI DESIGN & ARCHITECTS OFFICE
KIYOSHI SEY TAKEYAMA + AMORPHE	KIYOSHI SEY TAKEYAMA +AMORPHE
TADAHIRO TOH, ARCHIVISION ARCHITECT AND ASSOCIATES	TADAHIRO TOH ARCHIVISION ARCHITECT & ASSOCIATES
IZUE KAN ARCHITECTS & ENGINEERS, INC.	IZUE KAN ARCHITECTS & ENGINEERS
YASUDA ATLIER	YASUDA ATELIER
SHU-KOH-SHA ARCHITECTUAL&URBAN DESIGN STUDIO	SHU-KOH-SHA ARCHITECTURAL & URBAN DESIGN STUDIO
ENVIRONMENT DESIGN INSTITUTE	ENVIRONMENTAL DESIGN INSTITUTE
Y. ASHIHARA ARCHITECT & ASSOCIATES	Y.ASHIHARA ARCHITECT & ASSOCIATES
HIROKAZU SUEMITSU+YOKO SUEMITSU / SUEP.	HIROKAZU SUEMITSU+YOKO SUEMITSU/SUEP.
HIROKAZU SUEMITSU + YOKO SUEMITSU / SUEP.	HIROKAZU SUEMITSU+YOKO SUEMITSU/SUEP.
ITSUKO HASEGAWA ATERIER	ITSUKO HASEGAWA ATELIER

HIROFUMI OHNO/OHNO JAPAN	HIROFUMI OHNO / OHNO JAPAN

K.ITO ARCHITECTS&ENGINEERS	K.ITO ARCHITECTS & ENGINEERS
ATSUSHI KITAGAWAHARA	ATSUSHI KITAGAWARA
URBAN DEVELOPMENT CORPORATION	URBAN INFRASTRUCTURE DEVELOPMENT CORPORATION
MAKOTO TANIJIRI  / SUPPOSE DESIGN OFFICE	MAKOTO TANIJIRI / SUPPOSE DESIGN OFFICE
KAZUO SHINOHARA	KAZUO SHINOHARA ATELIER
KIYOSI SEIKE	KIYOSHI SEIKE
T. MURANO & MORI ASSOCIATED ARCHITECTS OFFICE	T.MURANO & MORI ASSOCIATED ARCHITECTS OFFICE
MAKI & ASSOCIATES	MAKI AND ASSOCIATES
K ARCHITECT AND ASSOCIATES	K ARCHITECT & ASSOCIATES
INTERDESIGN ASSOCIATES, ARCHITECTS	INTERDESIGN ASSOCIATES ARCHITECTS
MASAHIRO  IKEDA CO., LTD	MASAHIRO IKEDA CO., LTD
TAKASHI SUGIYAMA ARCHITECT & ASSOCIATES	TAKASHI SUGIYAMA ARCHITECT AND ASSOCIATES
K. AKIMOTO & PARTNERS	K.AKIMOTO & PARTNERS
YUKIO OTANI	SACHIO OTANI
MEGA	MÉGA
MINISTRY OF LAND,INFRASTRUCTRUCTURE AND TRANSPORT	MINISTRY OF LAND, INFRASTRUCTURE AND TRANSPORT
RYUJI NAKAMURA  & ASSOCIATES	RYUJI NAKAMURA & ASSOCIATES
KOBAYASHI MAKI DESIGN WORK SHOP	KOBAYASHI MAKI DESIGN WORKSHOP
ATELIER NANJYO	ATELIER NANJO

TADASHI OE	TADASU OHE
FUKUI ARCITECTS & ENGINEERS ASSOCIATION	FUKUI ARCHITECTS & ENGINEERS ASSOCIATION
KENCHIKU DESIGN STUDIO ,TOKY0	KENCHIKU DESIGN STUDIO
K.ITO ARCHITECTS & ENGINEERS INC	K.ITO ARCHITECTS & ENGINEERS
KIYOSHI SEY TAKEYAMA I AMORPHE ARCHITECTS & ASSOCIATES	KIYOSHI SEY TAKEYAMA +AMORPHE ARCHITECTS & ASSOCIATES

KOMADA TAKESHI+KOMADA YUKA/KOMADA ARCHITECTS’ OFFICE	KOMADA TAKESHI + KOMADA YUKA / KOMADA ARCHITECTS OFFICE
KOMADA TAKESHI + KOMADA YUKA /KOMADA ARCHITECTS' OFFICE	KOMADA TAKESHI + KOMADA YUKA / KOMADA ARCHITECTS OFFICE
SIN TOKI ARCHITECT & ASSOCIATES	SHIN TOKI ARCHITECT & ASSOCIATES
KIKO MOZUNA ARCHITECTS & ASSOCIATES	MOZUNA KIKOO ARCHITECTS & ASSOCIATES
KENYA ISHIHARA/DENEFES	KENYA ISHIHARA / DENEFES
SOGOSETSUBICONSULTING	SOGO SETSUBI CONSULTING
AKIHISA HIRATA LABOLATORY, KYOTO UNIVERSITY	AKIHISA HIRATA LABORATORY, KYOTO UNIVERSITY
TOKYO UNIVERSITY OF SCIENCE TAKU SAKAUSHI LABOLATORY	TOKYO UNIVERSITY OF SCIENCE TAKU SAKAUSHI LABORATORY
SHU-KOH-SHA ARCHITECTUAL & URBAN DESIGN STUDIO	SHU-KOH-SHA ARCHITECTURAL & URBAN DESIGN STUDIO
